/***
 *    ██╗   ██╗████████╗███████╗ █████╗ ██╗  ██╗
 *    ██║   ██║╚══██╔══╝██╔════╝██╔══██╗██║ ██╔╝
 *    ██║   ██║   ██║   █████╗  ╚██████║█████╔╝ 
 *    ██║   ██║   ██║   ██╔══╝   ╚═══██║██╔═██╗ 
 *    ╚██████╔╝   ██║   ██║      █████╔╝██║  ██╗
 *     ╚═════╝    ╚═╝   ╚═╝      ╚════╝ ╚═╝  ╚═╝
 *                                              
 */

# {{ .Page.Title }}
{{ .Date.Format "02 January 2006" }}

{{ replace (.Page.Plain | htmlUnescape) "\n" "\n\n" }}